-2	32	0	-2	32	32	-2	32	36	-2	32	100	-2	32	100	-2	32	100	-2	32	100	-2	32	100	-2	32	100	-2	32	102	-2	35	8	-2	35	0	-2	35	0	-2	35	0	-2	35	2	-2	32	108	-2	32	100	-2	32	100	-2	32	100	-2	32	100	-2	32	100	-2	32	100	-2	32	100	-2	32	100	-2	32	100	-2	32	100	-2	32	100	-2	32	68	-2	32	64	-2	32	0
-2	32	0	-2	32	34	-2	35	-39	-2	35	-111	-2	35	-111	-2	35	-111	-2	35	-111	-2	35	-111	-2	35	-111	-2	35	-127	-2	35	-128	-2	35	0	-2	35	0	-2	35	0	-2	35	16	-2	35	17	-2	35	-111	-2	35	-111	-2	35	-111	-2	35	-111	-2	35	-111	-2	35	-111	-2	35	-111	-2	35	-111	-2	35	-111	-2	35	-111	-2	35	-111	-2	35	-77	-2	32	72	-2	32	0
-2	32	0	-2	32	50	-2	35	-56	-2	35	0	-2	35	0	-2	35	0	-2	35	0	-2	35	0	-2	35	0	-2	35	0	-2	35	0	-2	35	0	-2	35	0	-2	35	0	-2	35	0	-2	35	0	-2	35	0	-2	35	0	-2	35	0	-2	35	0	-2	35	0	-2	35	0	-2	35	0	-2	35	0	-2	35	0	-2	35	0	-2	35	0	-2	35	50	-2	32	-56	-2	32	0
-2	32	0	-2	32	50	-2	35	-56	-2	35	0	-2	35	0	-2	35	0	-2	35	0	-2	35	0	-2	35	0	-2	35	0	-2	35	0	-2	35	0	-2	35	0	-2	35	0	-2	35	0	-2	35	0	-2	35	0	-2	35	0	-2	35	0	-2	35	0	-2	35	0	-2	35	0	-2	35	0	-2	35	0	-2	35	0	-2	35	0	-2	35	0	-2	35	50	-2	32	-56	-2	32	0
-2	32	0	-2	32	50	-2	35	-56	-2	35	0	-2	35	0	-2	35	0	-2	35	0	-2	35	0	-2	35	0	-2	35	0	-2	35	0	-2	35	0	-2	35	0	-2	35	0	-2	35	0	-2	35	0	-2	35	0	-2	35	0	-2	35	0	-2	35	0	-2	35	0	-2	35	0	-2	35	0	-2	35	0	-2	35	0	-2	35	0	-2	35	0	-2	35	50	-2	32	-56	-2	32	0
-2	32	0	-2	32	50	-2	35	-56	-2	35	0	-2	35	0	-2	35	0	-2	35	0	-2	35	0	-2	35	0	-2	35	0	-2	35	0	-2	35	0	-2	35	0	-2	35	0	-2	35	0	-2	35	0	-2	35	0	-2	35	0	-2	35	0	-2	35	0	-2	35	0	-2	35	0	-2	35	0	-2	35	0	-2	35	0	-2	35	0	-2	35	32	-2	35	54	-2	32	-56	-2	32	0
-2	32	0	-2	32	50	-2	35	-56	-2	35	0	-2	35	0	-2	35	0	-2	35	0	-2	35	0	-2	35	0	-2	35	0	-2	35	0	-2	35	0	-2	35	0	-2	35	0	-2	35	0	-2	35	0	-2	35	0	-2	35	0	-2	35	0	-2	35	0	-2	35	0	-2	35	0	-2	35	0	-2	35	0	-2	35	32	-2	35	36	-2	35	102	-2	43	-69	-2	32	-56	-2	32	0
-2	32	0	-2	32	50	-2	35	-56	-2	35	0	-2	35	0	-2	35	0	-2	35	0	-2	35	0	-2	35	0	-2	35	0	-2	35	0	-2	35	0	-2	35	0	-2	35	0	-2	35	0	-2	35	0	-2	35	0	-2	35	0	-2	35	0	-2	35	0	-2	35	0	-2	35	0	-2	35	0	-2	35	32	-2	35	38	-2	43	-103	-2	43	-127	-2	43	-78	-2	32	-56	-2	32	0
-2	32	0	-2	32	50	-2	35	-20	-2	35	68	-2	35	64	-2	35	0	-2	35	0	-2	35	0	-2	35	0	-2	35	0	-2	35	0	-2	35	0	-2	35	0	-2	35	0	-2	35	0	-2	35	0	-2	35	0	-2	35	0	-2	35	0	-2	35	0	-2	35	0	-2	35	0	-2	35	32	-2	35	38	-2	43	-119	-2	43	-128	-2	43	0	-2	43	50	-2	32	-56	-2	32	0
-2	32	0	-2	32	50	-2	43	-39	-2	43	-77	-2	35	72	-2	35	0	-2	35	0	-2	35	0	-2	35	0	-2	35	0	-2	35	0	-2	35	0	-2	35	0	-2	35	0	-2	35	0	-2	35	0	-2	35	0	-2	35	0	-2	35	0	-2	35	0	-2	35	0	-2	35	0	-2	35	34	-2	43	-55	-2	43	-128	-2	43	0	-2	43	0	-2	43	50	-2	32	-56	-2	32	0
-2	32	0	-2	32	50	-2	43	-56	-2	43	18	-2	35	-20	-2	35	68	-2	35	64	-2	35	0	-2	35	0	-2	35	0	-2	35	0	-2	35	0	-2	35	0	-2	35	0	-2	35	0	-2	35	0	-2	35	0	-2	35	0	-2	35	0	-2	35	0	-2	35	0	-2	35	0	-2	35	18	-2	43	-52	-2	43	64	-2	43	0	-2	43	0	-2	43	50	-2	32	-56	-2	32	0
-2	32	0	-2	32	50	-2	43	-56	-2	43	16	-2	43	17	-2	43	-109	-2	35	108	-2	35	100	-2	35	100	-2	35	100	-2	35	100	-2	35	68	-2	35	64	-2	35	0	-2	35	0	-2	35	0	-2	35	0	-2	35	0	-2	35	32	-2	35	36	-2	35	100	-2	35	100	-2	35	116	-2	35	119	-2	43	8	-2	43	0	-2	43	0	-2	43	50	-2	32	-56	-2	32	0
-2	32	0	-2	32	50	-2	43	-56	-2	43	0	-2	43	0	-2	43	16	-2	43	17	-2	43	-111	-2	43	-111	-2	43	-111	-2	43	-111	-2	43	-109	-2	35	108	-2	35	100	-2	35	100	-2	35	100	-2	35	100	-2	35	100	-2	35	102	-2	43	-103	-2	43	-111	-2	43	-111	-2	43	-111	-2	43	-127	-2	43	-128	-2	43	0	-2	43	0	-2	43	50	-2	32	-56	-2	32	0
-2	32	0	-2	32	18	-2	43	-20	-2	43	100	-2	43	100	-2	43	100	-2	43	100	-2	43	100	-2	43	100	-2	43	100	-2	43	100	-2	43	116	-2	43	117	-2	43	-11	-2	43	-11	-2	43	-11	-2	43	-11	-2	43	-43	-2	43	-63	-2	43	-128	-2	43	0	-2	43	0	-2	43	0	-2	43	0	-2	43	0	-2	43	0	-2	43	0	-2	43	50	-2	32	-56	-2	32	0
-2	32	0	-2	32	16	-2	32	17	-2	32	-111	-2	32	-111	-2	32	-111	-2	32	-111	-2	32	-111	-2	32	-111	-2	32	-111	-2	32	-111	-2	32	-111	-2	32	-111	-2	32	-111	-2	32	-111	-2	32	-111	-2	32	-111	-2	32	-109	-2	43	108	-2	43	100	-2	43	100	-2	43	100	-2	43	100	-2	43	100	-2	43	100	-2	43	100	-2	43	100	-2	43	118	-2	32	-120	-2	32	0
-2	32	0	-2	32	0	-2	32	0	-2	32	0	-2	32	0	-2	32	0	-2	32	0	-2	32	0	-2	32	0	-2	32	0	-2	32	0	-2	32	0	-2	32	0	-2	32	0	-2	32	0	-2	32	0	-2	32	0	-2	32	16	-2	32	17	-2	32	-111	-2	32	-111	-2	32	-111	-2	32	-111	-2	32	-111	-2	32	-111	-2	32	-111	-2	32	-111	-2	32	-127	-2	32	-128	-2	32	0
-2	32	0	-2	32	0	-2	32	0	-2	32	0	-2	32	0	-2	32	0	-2	32	0	-2	32	0	-2	32	0	-2	32	0	-2	32	0	-2	32	0	-2	32	0	-2	32	0	-2	32	0	-2	32	0	-2	32	0	-2	32	0	-2	32	0	-2	32	0	-2	32	0	-2	32	0	-2	32	0	-2	32	0	-2	32	0	-2	32	0	-2	32	0	-2	32	0	-2	32	0	-2	32	0
-2	32	0	-2	32	0	-2	32	0	-2	32	0	-2	32	0	-2	32	0	-2	32	0	-2	32	0	-2	32	0	-2	32	0	-2	32	0	-2	32	0	-2	32	0	-2	32	0	-2	32	0	-2	32	0	-2	32	0	-2	32	0	-2	32	0	-2	32	0	-2	32	0	-2	32	0	-2	32	0	-2	32	0	-2	32	0	-2	32	0	-2	32	0	-2	32	0	-2	32	0	-2	32	0
-2	32	0	-2	32	0	-2	32	0	-2	32	0	-2	32	0	-2	32	0	-2	32	0	-2	32	0	-2	32	0	-2	32	0	-2	32	0	-2	32	0	-2	32	0	-2	32	0	-2	32	0	-2	32	0	-2	32	0	-2	32	0	-2	32	0	-2	32	0	-2	32	0	-2	32	0	-2	32	0	-2	32	0	-2	32	0	-2	32	0	-2	32	0	-2	32	0	-2	32	0	-2	32	0
-2	32	0	-2	32	0	-2	32	0	-2	32	0	-2	32	0	-2	32	0	-2	32	0	-2	32	0	-2	32	0	-2	32	0	-2	32	0	-2	32	0	-2	32	0	-2	32	0	-2	32	0	-2	32	0	-2	32	0	-2	32	0	-2	32	0	-2	32	0	-2	32	0	-2	32	0	-2	32	0	-2	32	0	-2	32	0	-2	32	0	-2	32	0	-2	32	0	-2	32	0	-2	32	0
