-2	16	0	-2	16	0	-2	16	0	-2	16	0	-2	16	0	-2	16	0	-2	16	0	-2	16	0	-2	16	0	-2	16	0	-2	16	0	-2	16	0	-2	16	0	-2	16	0	-2	16	0	-2	16	0	-2	16	0	-2	16	0	-2	16	0	-2	16	0	-2	16	0	-2	16	0	-2	16	0	-2	16	0	-2	16	0	-2	16	0	-2	16	0	-2	16	0	-2	16	0	-2	16	0	-2	16	0	-2	16	0	-2	16	0	-2	16	0	-2	16	0	-2	16	0	-2	16	32	-2	16	36	-2	16	68	-2	16	64
-2	16	0	-2	16	0	-2	16	0	-2	16	0	-2	16	0	-2	16	0	-2	16	0	-2	16	0	-2	16	0	-2	16	0	-2	16	0	-2	16	0	-2	16	0	-2	16	0	-2	16	0	-2	16	0	-2	16	0	-2	16	0	-2	16	0	-2	16	0	-2	16	0	-2	16	0	-2	16	0	-2	16	0	-2	16	0	-2	16	0	-2	16	0	-2	16	0	-2	16	0	-2	16	0	-2	16	0	-2	16	0	-2	16	0	-2	16	0	-2	16	0	-2	16	0	-2	16	34	0	1	6	0	1	6	-2	16	72
-2	16	0	-2	16	0	-2	16	0	-2	16	0	-2	16	0	-2	16	0	-2	16	0	-2	16	0	-2	16	0	-2	16	0	-2	16	0	-2	16	0	-2	16	0	-2	16	0	-2	16	0	-2	16	0	-2	16	0	-2	16	0	-2	16	0	-2	16	0	-2	16	0	-2	16	0	-2	16	0	-2	16	0	-2	16	0	-2	16	0	-2	16	0	-2	16	0	-2	16	0	-2	16	0	-2	16	0	-2	16	0	-2	16	0	-2	16	0	-2	16	0	-2	16	0	-2	16	50	0	1	6	0	1	6	-2	16	-56
-2	16	0	-2	16	0	-2	16	0	-2	16	0	-2	16	0	-2	16	0	-2	16	0	-2	16	0	-2	16	0	-2	16	0	-2	16	0	-2	16	0	-2	16	0	-2	16	0	-2	16	0	-2	16	0	-2	16	0	-2	16	0	-2	16	0	-2	16	0	-2	16	0	-2	16	0	-2	16	0	-2	16	0	-2	16	0	-2	16	0	-2	16	0	-2	16	0	-2	16	0	-2	16	0	-2	16	0	-2	16	0	-2	16	0	-2	16	0	-2	16	0	-2	16	0	-2	16	50	0	1	6	0	1	6	-2	16	-56
-2	16	32	-2	16	4	-2	16	64	-2	16	0	-2	16	0	-2	16	0	-2	16	0	-2	16	0	-2	16	0	-2	16	0	-2	16	0	-2	16	0	-2	16	0	-2	16	0	-2	16	0	-2	16	0	-2	16	0	-2	16	0	-2	16	0	-2	16	0	-2	16	32	-2	16	4	-2	16	64	-2	16	0	-2	16	0	-2	16	0	-2	16	0	-2	16	0	-2	16	0	-2	16	0	-2	16	0	-2	16	0	-2	16	0	-2	16	0	-2	16	0	-2	16	0	-2	16	50	0	1	6	0	1	6	-2	16	-56
-2	16	34	-2	15	-37	-2	16	76	-2	16	64	-2	16	0	-2	16	0	-2	16	0	-2	16	0	-2	16	0	-2	16	0	-2	16	0	-2	16	0	-2	16	0	-2	16	0	-2	16	0	-2	16	0	-2	16	0	-2	16	0	-2	16	0	-2	16	0	-2	16	34	-2	15	-37	-2	16	108	-2	16	68	-2	16	64	-2	16	0	-2	16	0	-2	16	0	-2	16	0	-2	16	0	-2	16	0	-2	16	0	-2	16	0	-2	16	0	-2	16	0	-2	16	0	-2	16	50	0	1	6	0	1	6	-2	16	-56
-2	16	50	-2	15	-40	-2	15	19	-2	16	76	-2	16	64	-2	16	32	-2	16	4	-2	16	64	-2	16	0	-2	16	0	-2	16	0	-2	16	0	-2	16	0	-2	16	0	-2	16	0	-2	16	0	-2	16	0	-2	16	0	-2	16	0	-2	16	0	-2	16	50	-2	15	-40	-2	15	17	-2	15	-77	-2	16	72	-2	16	0	-2	16	0	-2	16	0	-2	16	0	-2	16	0	-2	16	0	-2	16	0	-2	16	0	-2	16	0	-2	16	0	-2	16	0	-2	16	50	0	1	6	0	1	6	-2	16	-56
-2	16	18	-2	15	-20	-2	15	116	-2	15	119	-2	16	8	-2	16	34	-2	15	-5	-2	16	72	-2	16	0	-2	16	0	-2	16	0	-2	16	0	-2	16	0	-2	16	0	-2	16	0	-2	16	0	-2	16	0	-2	16	0	-2	16	0	-2	16	0	-2	16	50	-2	15	-56	-2	15	32	-2	15	54	-2	16	-120	-2	16	0	-2	16	0	-2	16	0	-2	16	0	-2	16	0	-2	16	0	-2	16	0	-2	16	0	-2	16	0	-2	16	0	-2	16	0	-2	16	50	0	1	6	0	1	6	-2	16	-56
-2	16	16	-2	16	17	-2	16	-111	-2	16	-127	-2	16	-128	-2	16	50	-2	15	-6	-2	16	-56	-2	16	0	-2	16	0	-2	16	0	-2	16	0	-2	16	0	-2	16	32	-2	16	4	-2	16	96	-2	16	36	-2	16	100	-2	16	100	-2	16	100	-2	16	118	-2	15	-20	-2	15	102	-2	16	-19	-2	16	-28	-2	16	100	-2	16	100	-2	16	100	-2	16	100	-2	16	100	-2	16	100	-2	16	100	-2	16	100	-2	16	100	-2	16	100	-2	16	100	-2	16	118	0	1	6	0	1	6	-2	16	-56
-2	16	0	-2	16	0	-2	16	0	-2	16	0	-2	16	0	-2	16	18	-2	15	-2	-2	16	-120	-2	16	0	-2	16	0	-2	16	0	-2	16	0	-2	16	32	-2	16	38	-2	15	-69	-2	16	106	0	1	6	0	1	6	0	1	6	0	1	6	0	1	6	4	6	12	4	6	12	0	1	6	0	1	6	0	1	6	0	1	6	0	1	6	0	1	6	0	1	6	0	1	6	0	1	6	0	1	6	0	1	6	0	1	6	0	1	6	0	1	6	0	1	6	0	1	6	-2	16	-56
-2	16	0	-2	16	0	-2	16	0	-2	16	0	-2	16	0	-2	16	16	-2	16	1	-2	16	-128	-2	16	0	-2	16	0	-2	16	0	-2	16	0	-2	16	34	-2	15	-55	-2	15	-78	-2	16	-6	0	1	6	0	1	6	0	1	6	0	1	6	0	1	6	4	6	12	4	6	12	0	1	6	0	1	6	0	1	6	0	1	6	0	1	6	0	1	6	0	1	6	0	1	6	0	1	6	0	1	6	0	1	6	0	1	6	0	1	6	0	1	6	0	1	6	0	1	6	-2	16	-120
-2	16	0	-2	16	0	-2	16	0	-2	16	0	-2	16	0	-2	16	0	-2	16	0	-2	16	0	-2	16	0	-2	16	0	-2	16	0	-2	16	0	-2	16	50	-2	15	-56	-2	15	50	-2	16	-6	-2	15	-5	0	1	6	-2	16	-39	-2	16	-111	-2	16	-109	-2	15	-3	-2	15	-9	-2	16	-103	-2	16	-111	-2	16	-111	-2	16	-111	-2	16	-111	-2	16	-111	-2	16	-111	-2	16	-111	-2	16	-111	-2	16	-111	-2	16	-111	-2	16	-111	-2	16	-111	-2	16	-111	-2	16	-111	-2	16	-127	-2	16	-128
-2	16	0	-2	16	0	-2	16	0	-2	16	0	-2	16	0	-2	16	0	-2	16	0	-2	16	0	-2	16	0	-2	16	0	-2	16	0	-2	16	0	-2	16	18	-2	15	-20	-2	15	118	-2	16	-70	-2	15	-6	0	1	6	-2	16	-56	-2	16	0	-2	16	16	-2	16	17	-2	16	-127	-2	16	-128	-2	16	0	-2	16	0	-2	16	0	-2	16	0	-2	16	0	-2	16	32	-2	16	36	-2	16	100	-2	16	100	-2	16	100	-2	16	100	-2	16	100	-2	16	100	-2	16	68	-2	16	64	-2	16	0
-2	16	0	-2	16	0	-2	16	0	-2	16	0	-2	16	0	-2	16	0	-2	16	0	-2	16	0	-2	16	0	-2	16	0	-2	16	0	-2	16	0	-2	16	16	-2	16	17	-2	16	-127	-2	16	-78	-2	15	-6	0	1	6	-2	16	-56	-2	16	0	-2	16	0	-2	16	0	-2	16	0	-2	16	0	-2	16	0	-2	16	0	-2	16	0	-2	16	0	-2	16	0	-2	16	34	-2	15	-39	-2	15	-111	-2	15	-111	-2	15	-111	-2	15	-111	-2	15	-111	-2	15	-111	-2	15	-77	-2	16	72	-2	16	0
-2	16	0	-2	16	0	-2	16	32	-2	16	4	-2	16	64	-2	16	0	-2	16	0	-2	16	0	-2	16	0	-2	16	0	-2	16	0	-2	16	0	-2	16	0	-2	16	0	-2	16	0	-2	16	50	-2	15	-2	0	1	6	-2	16	-56	-2	16	0	-2	16	0	-2	16	0	-2	16	0	-2	16	0	-2	16	0	-2	16	0	-2	16	0	-2	16	0	-2	16	0	-2	16	50	-2	15	-56	-2	15	0	-2	15	0	-2	15	0	-2	15	0	-2	15	0	-2	15	0	-2	15	50	-2	16	-56	-2	16	0
-2	16	0	-2	16	0	-2	16	34	-2	15	-37	-2	16	76	-2	16	64	-2	16	0	-2	16	0	-2	16	0	-2	16	0	-2	16	0	-2	16	0	-2	16	0	-2	16	0	-2	16	0	-2	16	50	0	1	6	0	1	6	-2	16	-56	-2	16	0	-2	16	0	-2	16	0	-2	16	0	-2	16	0	-2	16	0	-2	16	0	-2	16	0	-2	16	0	-2	16	0	-2	16	50	-2	15	-56	-2	15	0	-2	15	0	-2	15	0	-2	15	0	-2	15	0	-2	15	0	-2	15	50	-2	16	-56	-2	16	0
-2	16	0	-2	16	0	-2	16	18	-2	15	-36	-2	15	83	-2	16	76	-2	16	64	-2	16	0	-2	16	0	-2	16	0	-2	16	0	-2	16	0	-2	16	0	-2	16	0	-2	16	0	-2	16	50	0	1	6	0	1	6	-2	16	-56	-2	16	0	-2	16	0	-2	16	0	-2	16	0	-2	16	32	-2	16	4	-2	16	64	-2	16	0	-2	16	0	-2	16	0	-2	16	50	-2	15	-56	-2	15	0	-2	15	0	-2	15	0	-2	15	0	-2	15	0	-2	15	0	-2	15	50	-2	16	-56	-2	16	0
-2	16	0	-2	16	0	-2	16	16	-2	16	19	-2	15	124	-2	15	119	-2	16	8	-2	16	0	-2	16	0	-2	16	0	-2	16	0	-2	16	0	-2	16	0	-2	16	0	-2	16	0	-2	16	50	0	1	6	0	1	6	-2	16	-56	-2	16	0	-2	16	0	-2	16	0	-2	16	0	-2	16	34	-2	15	-5	-2	16	72	-2	16	0	-2	16	0	-2	16	0	-2	16	50	-2	15	-56	-2	15	0	-2	15	0	-2	15	0	-2	15	0	-2	15	0	-2	15	0	-2	15	50	-2	16	-56	-2	16	0
-2	16	0	-2	16	0	-2	16	0	-2	16	16	-2	16	17	-2	16	-127	-2	16	-128	-2	16	0	-2	16	0	-2	16	0	-2	16	0	-2	16	0	-2	16	0	-2	16	0	-2	16	0	-2	16	50	0	1	6	0	1	6	-2	16	-56	-2	16	0	-2	16	0	-2	16	0	-2	16	0	-2	16	18	-2	15	-2	-2	16	-120	-2	16	0	-2	16	0	-2	16	0	-2	16	50	-2	15	-56	-2	15	0	-2	15	0	-2	15	0	-2	15	0	-2	15	0	-2	15	0	-2	15	50	-2	16	-56	-2	16	0
-2	16	0	-2	16	0	-2	16	0	-2	16	0	-2	16	0	-2	16	0	-2	16	0	-2	16	0	-2	16	0	-2	16	0	-2	16	0	-2	16	0	-2	16	0	-2	16	0	-2	16	0	-2	16	50	0	1	6	0	1	6	-2	16	-56	-2	16	0	-2	16	0	-2	16	0	-2	16	0	-2	16	16	-2	16	1	-2	16	-128	-2	16	0	-2	16	0	-2	16	0	-2	16	50	-2	15	-56	-2	15	0	-2	15	0	-2	15	0	-2	15	0	-2	15	0	-2	15	0	-2	15	50	-2	16	-56	-2	16	0
-2	16	0	-2	16	0	-2	16	0	-2	16	0	-2	16	32	-2	16	4	-2	16	64	-2	16	0	-2	16	0	-2	16	0	-2	16	0	-2	16	0	-2	16	0	-2	16	0	-2	16	0	-2	16	50	0	1	6	0	1	6	-2	16	-56	-2	16	0	-2	16	0	-2	16	0	-2	16	0	-2	16	0	-2	16	0	-2	16	0	-2	16	0	-2	16	0	-2	16	0	-2	16	18	-2	15	-20	-2	15	100	-2	15	100	-2	15	100	-2	15	100	-2	15	100	-2	15	100	-2	15	118	-2	16	-120	-2	16	0
-2	16	0	-2	16	0	-2	16	0	-2	16	0	-2	16	34	-2	15	-5	-2	16	72	-2	16	0	-2	16	0	-2	16	0	-2	16	0	-2	16	0	-2	16	0	-2	16	0	-2	16	0	-2	16	50	0	1	6	0	1	6	-2	16	-56	-2	16	0	-2	16	0	-2	16	0	-2	16	0	-2	16	0	-2	16	0	-2	16	0	-2	16	0	-2	16	0	-2	16	0	-2	16	16	-2	16	17	-2	16	-111	-2	16	-111	-2	16	-111	-2	16	-111	-2	16	-111	-2	16	-111	-2	16	-127	-2	16	-128	-2	16	0
-2	16	0	-2	16	0	-2	16	0	-2	16	0	-2	16	50	-2	15	-38	-2	16	-52	-2	16	64	-2	16	0	-2	16	0	-2	16	0	-2	16	0	-2	16	0	-2	16	0	-2	16	0	-2	16	50	0	1	6	0	1	6	-2	16	-56	-2	16	0	-2	16	0	-2	16	0	-2	16	0	-2	16	0	-2	16	0	-2	16	0	-2	16	0	-2	16	0	-2	16	0	-2	16	0	-2	16	0	-2	16	0	-2	16	0	-2	16	0	-2	16	0	-2	16	0	-2	16	0	-2	16	0	-2	16	0	-2	16	0
-2	16	0	-2	16	0	-2	16	0	-2	16	0	-2	16	18	-2	15	-4	-2	15	119	-2	16	8	-2	16	0	-2	16	0	-2	16	0	-2	16	0	-2	16	0	-2	16	0	-2	16	0	-2	16	50	0	1	6	0	1	6	-2	16	-56	-2	16	0	-2	16	0	-2	16	0	-2	16	0	-2	16	0	-2	16	0	-2	16	0	-2	16	0	-2	16	32	-2	16	36	-2	16	68	-2	16	64	-2	16	0	-2	16	0	-2	16	0	-2	16	0	-2	16	0	-2	16	0	-2	16	0	-2	16	0	-2	16	0
-2	16	36	-2	16	100	-2	16	100	-2	16	100	-2	16	116	-2	16	117	-2	16	-27	-2	16	-28	-2	16	100	-2	16	100	-2	16	100	-2	16	100	-2	16	100	-2	16	100	-2	16	100	-2	16	118	0	1	6	0	1	6	-2	16	-56	-2	16	0	-2	16	32	-2	16	36	-2	16	100	-2	16	68	-2	16	64	-2	16	0	-2	16	0	-2	16	34	-2	15	-39	-2	15	-77	-2	16	72	-2	16	0	-2	16	0	-2	16	0	-2	16	0	-2	16	0	-2	16	0	-2	16	0	-2	16	0	-2	16	0
0	1	6	0	1	6	0	1	6	0	1	6	0	1	6	0	1	6	0	1	6	0	1	6	0	1	6	0	1	6	0	1	6	0	1	6	0	1	6	0	1	6	0	1	6	0	1	6	0	1	6	0	1	6	-2	16	-56	-2	16	32	-2	16	38	-2	15	-103	-2	15	-111	-2	15	-109	-2	16	76	-2	16	64	-2	16	0	-2	16	18	-2	15	-20	-2	15	118	-2	16	-120	-2	16	0	-2	16	0	-2	16	0	-2	16	0	-2	16	0	-2	16	0	-2	16	0	-2	16	0	-2	16	0
0	1	6	0	1	6	0	1	6	0	1	6	0	1	6	0	1	6	0	1	6	0	1	6	0	1	6	0	1	6	0	1	6	0	1	6	0	1	6	0	1	6	0	1	6	0	1	6	0	1	6	0	1	6	-2	16	-120	-2	16	2	-2	15	-19	-2	15	-60	-2	15	64	-2	15	16	-2	15	19	-2	16	76	-2	16	64	-2	16	16	-2	16	17	-2	16	-127	-2	16	-128	-2	16	0	-2	16	0	-2	16	0	-2	16	0	-2	16	0	-2	16	0	-2	16	0	-2	16	0	-2	16	0
-2	16	17	-2	16	-109	-2	32	-1	-2	16	-103	-2	16	-111	-2	16	-111	-2	16	-111	-2	16	-111	-2	16	-111	-2	16	-111	-2	16	-111	-2	16	-111	-2	16	-111	-2	16	-111	-2	16	-111	-2	16	-111	-2	16	-111	-2	16	-127	-2	16	-128	-2	16	16	-2	16	17	-2	16	-109	-2	15	76	-2	15	64	-2	15	16	-2	15	51	-2	16	72	-2	16	0	-2	16	0	-2	16	0	-2	16	0	-2	16	0	-2	16	0	-2	16	0	-2	16	0	-2	16	0	-2	16	0	-2	16	0	-2	16	0	-2	16	0
-2	16	0	-2	16	16	-2	16	1	-2	16	-128	-2	16	0	-2	16	0	-2	16	0	-2	16	0	-2	16	0	-2	16	0	-2	16	0	-2	16	0	-2	16	0	-2	16	0	-2	16	0	-2	16	0	-2	16	0	-2	16	0	-2	16	0	-2	16	0	-2	16	0	-2	16	16	-2	16	19	-2	15	108	-2	15	100	-2	15	118	-2	16	-120	-2	16	0	-2	16	0	-2	16	0	-2	16	0	-2	16	0	-2	16	0	-2	16	0	-2	16	0	-2	16	0	-2	16	0	-2	16	0	-2	16	0	-2	16	0
-2	16	0	-2	16	0	-2	16	0	-2	16	0	-2	16	0	-2	16	0	-2	16	0	-2	16	0	-2	16	0	-2	16	0	-2	16	0	-2	16	0	-2	16	0	-2	16	0	-2	16	0	-2	16	0	-2	16	0	-2	16	0	-2	16	0	-2	16	0	-2	16	0	-2	16	0	-2	16	16	-2	16	17	-2	16	-111	-2	16	-127	-2	16	-128	-2	16	0	-2	16	0	-2	16	0	-2	16	0	-2	16	0	-2	16	0	-2	16	0	-2	16	0	-2	16	0	-2	16	0	-2	16	0	-2	16	0	-2	16	0
